{
  "type": "jungle",
  "tiles": [
    "%%%%%%%%%%%%%%%%%%%%%%%%%%%%%%%%%%%%%%%%%%%%%%%%%%%%%%%%%%%%%%%%%%%%%%%%%%%%%%%%%%%%%%%%%%%%%%%%%%%%%%%%%%",
    "%.................................................................................................$$$$$..%",
    "%.................................................................................................$$$$$F.%",
    "%.............................................$.....$............................................########%",
    "%............................................$$$...$$$............................#..#..#................%",
    "%.............................................$.....$......................####xxxxxxxxxxxx###...........%",
    "%.............................................................................##############.............%",
    "%@...^H..............................^H.......#.....#..........^H^.......................................%",
    "%#########...1...............2...#########................##############......................###########%",
    "%........#########..1...##########.......#xxxxxxxxxxxxxxxx#............#............................$$$$.%",
    "%................########................##################............#..........1.....1......1.........%",
    "%......................................................................#.......#####################.....%",
    "%......................................................................#...........$$$$$$$$$$$$$$........%",
    "%......................................................................#.....1.....2....3.......1........%",
    "%......................................................................##################################%",
    "%%%%%%%%%%%%%%%%%%%%%%%%%%%%%%%%%%%%%%%%%%%%%%%%%%%%%%%%%%%%%%%%%%%%%%%%%%%%%%%%%%%%%%%%%%%%%%%%%%%%%%%%%%"
  ],
  "lives": 3
}