{
  "type": "jungle",
  "tiles": [
    "%%%%%%%%%%%%%%%%%%%%%%%%%%%%%%%%%%%%%%%%%%%%%%%%%%%%%%%%%%%%%%%%%%%%%%%%%%%%%%%%%%%%%%%%%%%%%%%%%%%%%%%%%%",
    "%.................................................................................................$$$$$$$%",
    "%.................................................................................................$$$$$$$%",
    "%.................................................................................................$$$$$$$%",
    "%...............$..............$..............$..........................................................%",
    "%..............$$$.....#......$$$.....#......$$$..............................222222111111111113333333333%",
    "%.............$$$$$..........$$$$$..........$$$$$............................############################%",
    "%............$$$$$$$........$$$$$$$........$$$$$$$.......................................................%",
    "%............^$$$$$^.....#...$$$$$.......#.^$$$$$^..............#........#...............................%",
    "%.............^$$$^..........H$$$H..........^$$$^...............#........#...............................%",
    "%..............^$^............H$H............^$^................#........#...............................%",
    "%...............^.....#........H......#.......^.............#........#.......#.....#.....................%",
    "%...........................................................#........#.......#.....#.....................%",
    "%..@.....^H.................................................#xxxxxxxx#xxxxxxx#xxxxx#....................F%",
    "%########################################################################################################%",
    "%%%%%%%%%%%%%%%%%%%%%%%%%%%%%%%%%%%%%%%%%%%%%%%%%%%%%%%%%%%%%%%%%%%%%%%%%%%%%%%%%%%%%%%%%%%%%%%%%%%%%%%%%%"
  ],
  "lives": 3
}