{
  "type": "jungle",
  "tiles": [
    "%%%%%%%%%%%%%%%%%%%%%%%%%%%%%%%%%%%%%%%%%%%%%%%%%%%%%%%%%%%%%%%%%%%%%%%%%%%%%%%%%%%%%%%%%%%%%%%%%%%%%%%%%%",
    "%........................................................................................................%",
    "%............3...........................................................................................%",
    "%.........$$$$$$H........................................................................................%",
    "%.......###########......................................................................................%",
    "%......................###...............................................................................%",
    "%.........................................1.2....................$..$....................................%",
    "%.................###...................#######................#########.................................%",
    "%.....................................................H^...............#.................................%",
    "%.....................###..........................########............#.................................%",
    "%............................^............3............................#....2.........3.......1....$$$..F%",
    "%..........................######.....###########......................##################################%",
    "%......@...^...######....................................................................................%",
    "%############............................................................................................%",
    "%////////////////////////////////////////////////////////////////////////////////////////////////////////%",
    "%%%%%%%%%%%%%%%%%%%%%%%%%%%%%%%%%%%%%%%%%%%%%%%%%%%%%%%%%%%%%%%%%%%%%%%%%%%%%%%%%%%%%%%%%%%%%%%%%%%%%%%%%%"
  ],
  "lives": 2
}