{
  "type": "jungle",
  "tiles": [
    "%%%%%%%%%%%%%%%%%%%%%%%%%%%%%%%%%%%%%%%%%%%%%%%%%%%%%%%%%%%%%%%%%%%%%%%%%%%%%%%%%%%%%%%%%%%%%%%%%%%%%%%%%%",
    "%.................................................................................................$$$$$$$%",
    "%.................................................................................................$$$$$$$%",
    "%.........................................................##########................................^^.##%",
    "%.F.....2.....1.........2......3.......3......2....3...####..............................................%",
    "%#######################################################...............###.......................##......%",
    "%........................................................................................................%",
    "%........................................................................................................%",
    "%................................................................###........###......##.....##.......##..%",
    "%..................................^H^...................................................................%",
    "%...............................########.................................................................%",
    "%..........................#............x..............................###...............................%",
    "%.....................#..................#...............................................................%",
    "%..@.............#........................xxx#......1......2.....3.......................................%",
    "%########xxxx#xxxxxxxxxxxxxxxxxxxxxxxxxxxx###############################################################%",
    "%%%%%%%%%%%%%%%%%%%%%%%%%%%%%%%%%%%%%%%%%%%%%%%%%%%%%%%%%%%%%%%%%%%%%%%%%%%%%%%%%%%%%%%%%%%%%%%%%%%%%%%%%%"
  ],
  "lives": 4
}