{
  "type": "jungle",
  "tiles": [
    "%%%%%%%%%%%%%%%%%%%%%%%%%%%%%%%%%%%%%%%%%%%%%%%%%%%%%%%%%%%%%%%%%%%%%%%%%%%%%%%%%%%%%%%%%%%%%%%%%%%%%%%%%%",
    "%...#....................................................................................................%",
    "%.@.#................................11...................11.............................................%",
    "%...#..............................#########...1.....#############......1....2...........................%",
    "%...#......................2................#########.............################.......................%",
    "%...#..................#########.................................................#.......................%",
    "%...#............................................................................#.......................%",
    "%...#.........1..................................................................#.......................%",
    "%...#....##########..............................................................#.......................%",
    "%...#............................................................................#.....3....3..33..3....F%",
    "%...#....................2........................................................#######################%",
    "%...#..................#######...........................................................................%",
    "%...#........1........................................................................$$$$$$$$$$$$$$$$$$$%",
    "%.........#########.............................#.....#......#......#....#............$$$$$$$$$$$$$$$$$$$%",
    "%..........................................#////////////////////////////////#.........^^HH^^HH^^.........%",
    "%########################################################################################################%",
    "%%%%%%%%%%%%%%%%%%%%%%%%%%%%%%%%%%%%%%%%%%%%%%%%%%%%%%%%%%%%%%%%%%%%%%%%%%%%%%%%%%%%%%%%%%%%%%%%%%%%%%%%%%"
  ],
  "lives": 3
}