{
  "type": "jungle",
  "tiles": [
    "%%%%%%%%%%%%%%%%%%%%%%%%%%%%%%%%%%%%%%%%%%%%%%%%%%%%%%%%%%%%%%%%%%%%%%%%%%%%%%%%%%%%%%%%%%%%%%%%%%%%%%%%%%",
    "%..............$$$$$$....................................................................................%",
    "%............................................................................$$.....$$...................%",
    "%F..........3......2.....1..........3.........2......1...................................................%",
    "%#############################################################...H.^^^...................................%",
    "%............................................................##############xxxx####xxxx########..........%",
    "%.........................................................................##############.................%",
    "%.........................$$..........$$$.........$$$$......$$..............................HH...........%",
    "%.........................................................................................########.......%",
    "%.........................1.....1......1.......1.........................33.......2.......#..............%",
    "%.......###...###.....^##############################xx#xx#xx#xx###########################..............%",
    "%....................^#.............................#############........................................%",
    "%...................^#...................................................................................%",
    "%...@...............#....................................................................................%",
    "%#######xxx###xxx###/////////////////////////////////////////////////////////////////////////////////////%",
    "%%%%%%%%%%%%%%%%%%%%%%%%%%%%%%%%%%%%%%%%%%%%%%%%%%%%%%%%%%%%%%%%%%%%%%%%%%%%%%%%%%%%%%%%%%%%%%%%%%%%%%%%%%"
  ],
  "lives": 3
}