{
  "type": "jungle",
  "tiles": [
    "%%%%%%%%%%%%%%%%%%%%%%%%%%%%%%%%%%%%%%%%%%%%%%%%%%%%%%%%%%%%%%%%%%",
    "%............HHHH................................................%",
    "%...........@HHHH................................................%",
    "%.........$$$$$$$..............3.H.................3.............%",
    "%.........#######............#######............#######..........%",
    "%.....2..............^H..F...............3.......................%",
    "%...####...........########...........########...........####....%",
    "%............2..................^H...............................%",
    "%.........#######............#######............#######..........%",
    "%.....................^H.................^H......................%",
    "%...####.....1.....########...........########...........####....%",
    "%..........^H..................H................................%",
    "%.........#######............#######............#######..........%",
    "%.......................................H^.......................%",
    "%...####...........########...........########...........####....%",
    "%.......#.........#..............................................%",
    "%...............1................................................%",
    "%/////////<#######>xxxxxxxxxxx///////////////////////////////////%",
    "%%%%%%%%%%%%%%%%%%%%%%%%%%%%%%%%%%%%%%%%%%%%%%%%%%%%%%%%%%%%%%%%%%"
  ],
  "more": {}
}